BBBBBBBB
B      B
B BBB  B
BaB B BB
B B    B
BBB B BB
BA  B  B
BBBBBBBB