BBBBBBBBBBBBB
Ba    B BBBBB
B BBB B     B
B B B BBBBB B
B B         B
BBB BBBBBBBBB
B     B   BAB
B BBB B B B B
B B B   B B B
B   B BBB   B
BBBBBBBBBBBBB