BBBBBBBBBBBBBBBBBBBBBBBBB
B       a               B
BBB BBBBBBB BBBBBB BBBB B
B      BBBB   BBBB BBBB B
B BBBB BBBBBB BBB  BBBBBB
B         B    B  BBBBBBB
BBB BBBBBBBBBB BBBBBBBBBB
BBB BBBB                B
B                       B
BBBBBBBBBBBBBBBBBBBBBBB B
B                       B
B BBBBBBBBBBBBBBBBBBBBB B
B         A             B
BBBBBBBBBBBBBBBBBBBBBBBBB