BBBBBBBBB
Ba  BA  B
BBB BBB B
B   B   B
B BBB BBB
B   B   B
BBB   BBB
BBBBBBBBB