BBBBBBBBB
BaB     B
B BBB B B
B B   B B
B B BBB B
B   B   B
BBBBB BBB
B      AB
BBBBBBBBB