BBBBBBBBBBB
BA        B
BBB BBB BBB
BBBBBBB BBB
B         B
BBB BBBBBBB
B   BBBBB B
B BBBBBBBBB
B         B
BBBBBBBBB B
Ba        B
BBBBBBBBBBB