BBBBBBBBBBBBBBBBBBBBBBBB
B           B          B
B BBBBBBBBB   BBBBBBBB B
B B       B          B B
B BBBBBBB B     BBBB B B
B B       B B      B B B
B B B B BBB B BBBB B B B
B B B B   B B    B B B B
B B B B B B BBBB B B B B
B B B B B        B     B
B   B   B       BBBBBB B
BBBBBBBBB B            B
BA        Ba BBBBBBBBBBB
BBBBBBBBBBBBBBBBBBBBBBBB